31 31 
32 32 
6 0 0 0 0 0 0 0 0 0 0 0 0 0 0 0 0 0 0 0 0 0 0 0 0 0 0 0 0 0 7
5 1 1 1 2 1 1 1 1 1 1 1 0 1 1 1 1 1 0 1 2 1 1 1 1 1 1 1 1 1 5
5 1 0 1 0 1 0 1 0 0 0 0 0 1 0 0 0 1 0 1 2 1 0 0 0 1 0 1 0 1 5 															
5 1 0 1 1 1 0 1 1 1 2 1 1 1 0 1 1 1 0 1 1 1 0 1 1 1 1 1 0 1 5  																
5 0 0 0 0 0 0 0 0 1 2 1 0 0 0 1 0 0 0 0 0 0 0 1 0 0 0 0 0 1	5													
5 1 1 1 1 1 1 1 1 1 0 1 1 1 0 1 1 1 1 1 1 1 1 1 0 1 1 1 0 1 5															
5 1 0 0 0 0 0 0 0 1 0 0 0 1 0 0 0 0 0 0 0 0 0 0 0 1 0 0 0 1 5 															
5 1 1 1 0 1 1 1 1 1 1 1 1 1 0 1 1 1 1 1 1 1 0 1 1 1 1 1 1 1 5														
5 2 0 1 0 0 0 0 0 2 0 0 0 0 0 1 0 0 0 1 0 1 0 1 0 0 2 0 0 2 5																
5 1 1 1 0 1 1 1 1 1 1 1 2 1 1 1 0 1 0 1 0 4 0 1 0 1 1 1 1 1 5													
5 1 0 2 0 1 0 0 2 0 0 1 0 0 0 1 0 1 0 4 0 0 0 1 0 1 0 2 0 1 5 
5 1 1 1 0 1 0 1 1 1 0 1 1 1 0 1 1 1 0 1 1 1 0 1 2 1 0 1 1 1 5 
5 0 0 1 0 1 0 1 0 1 0 0 0 1 0 0 0 0 0 0 0 1 2 1 0 1 0 0 0 0 5 
5 1 0 1 1 1 0 1 0 1 1 1 0 1 1 1 0 1 1 1 1 1 0 1 0 1 1 1 1 1 5 															
5 1 0 0 0 0 0 0 0 0 0 1 0 0 0 0 0 1 0 0 0 0 0 1 0 0 0 0 0 1 5															
5 1 1 1 1 1 0 1 1 1 1 1 1 1 0 1 1 1 0 1 1 1 1 1 0 1 1 1 1 1 5															
5 2 2 1 0 1 0 1 0 0 0 0 0 1 0 1 0 1 0 1 0 0 2 0 0 1 0 0 0 0 5															
5 1 1 1 0 1 1 1 0 1 1 1 0 1 2 1 0 1 2 1 0 1 1 1 0 1 1 1 1 1 5															
5 1 0 2 0 0 0 0 0 1 0 0 0 1 0 1 0 1 0 1 0 1 0 1 0 0 0 0 0 1 5 															
5 1 1 1 0 1 1 1 0 1 1 1 1 1 0 1 0 1 0 1 0 1 0 1 1 1 1 1 1 1 5 															
5 1 0 1 0 1 0 1 0 1 0 0 0 0 0 1 0 1 0 1 2 1 0 0 0 0 0 0 0 1 5															
5 1 2 1 2 1 0 1 1 1 0 1 1 1 1 1 0 1 1 1 0 1 1 1 1 1 1 1 0 1 5 															
5 0 0 1 0 0 0 2 0 0 0 1 0 0 0 0 0 0 0 0 0 1 0 0 2 0 0 1 0 0 5  															
5 1 1 1 2 1 1 1 1 1 0 1 0 1 1 1 0 1 1 1 1 1 0 1 1 1 0 1 1 1 5															
5 1 0 0 0 1 0 0 0 1 0 1 0 1 0 2 0 1 0 1 0 0 0 1 0 1 0 0 0 1 5  															
5 1 1 1 1 1 1 1 0 1 2 1 0 1 1 1 1 1 0 1 1 1 0 1 0 1 1 1 0 1 5															
5 0 0 0 0 2 0 0 0 1 0 1 0 0 0 0 0 0 0 0 0 1 0 0 0 0 0 1 0 1 5  															
5 1 1 1 1 1 1 1 1 1 0 1 1 1 0 1 1 1 1 1 0 1 1 1 1 1 1 1 0 1 5 																
5 1 0 0 0 0 0 0 2 0 0 0 0 1 0 1 0 0 0 1 0 0 0 0 2 0 0 0 0 1 5 															
5 1 1 1 1 1 1 1 1 1 1 1 1 1 1 1 0 1 1 1 1 1 1 1 1 1 1 1 1 1 1															
8 0 0 0 0 0 0 0 0 0 0 0 0 0 0 0 0 0 0 0 0 0 0 0 0 0 0 0 0 0 9 
